11111111111111111111
100000P00000C0000001
10101111010101110101
1C0000000000000000C1
10111010101110111011
1C0000000C0000C00001
11101011101010101011
1C0000000000000000C1
11101110101110111011
1C0000000C0000C00001
10101010101010101011
1C0000000000000000E1
11111111111111111111