1111111111111111111111111111111111111111
100000P00000C0000000000000C00000C0000001
1010111101010111010110101111010101110101
1C0000000000000000C10C0000000000000000C1
1011101010111011100110111010101110111011
1C0000000C0000C000000C0000000C0000C00001
1110101110101010111111101011101010101011
1C0000000000000001C00C0000000000000000C1
1110111010111011111111101110101110111011
1C0000000C0000C000000C1000000C0000C00001
1010101010101010101110101010101010111011
1C00000000000000001C0C0000000000000000E1
1111111111111111111111111111111111111111